0001001001001001001001001001001001001001001001001001001001001001001001001001001001001001001001001001001001001001001001001001001001001001001001001001001001001001001001001001001001001001001001001001001001001001001001001001001001001001001001001001001001001001001001001001001001001001001001001001001001001001001001001001001001001001001001001001001001001001001001001001001001001001001001001001001001001001
0001001001001002001001001002001001001001001001001001001001001001002001001001001001001001001001001002001001001001001001001001001002001001001001001001001001001002001001001001001001001001001002001001001001001001001001002001001001001001001001001001001001001002001001001001001001001001001002001001001001001001001001001002001001001001001001001001002001001001001001001001001001001001002001001001001001001001
0002001001001000001001001000001001001001001001001002001001001001000001001001001001002001001001001000001001001001002001001001001000001001001001002001001001001000001001001001001002001001001000001001001001001001001001000001001001001001001001002001001001001000001001001001002001001001001000001001001001001002001001001000001001001001001001001001000001001001001001001001001001001001000001001001001001001001
0000001001001000001001001001001001001001001001001000001001001001000001001001001001000001001001002000001001001001000001001001001000001001001001000001001001001000001001001001001000001001001000001001001001001001001001000001001001001001001001000001001001001000001001001001000001001001001000001001001001001000001001001000001001001001001001001001000001001001001001001001001001001001000001001001001001001001
0000002001002002001001002001001001002001001001001000001002001001002001002001002001000002001001000002001001002001000002001001002002001001001002000002001001002002001001002001001000001001001002002001001001001002001001002001002001002001001002000002001001002002001001001002000002001001002002001001002001001000001001001002002001001001001002001001002001002001002001001002001002001001002001002001002001001002
0002000002000000002002000002002002000002002002002002002000002002001002000002000002002000002002000001002002000002002000002002000001002001002000002000002001000001002001000002001002002001002001000002001002002000002002001002000001000002002000002000002002000001002001002000002000002001000001002001000002001002002001002001000002001002002000002002001002000001000002002000002000002002001002000001000002002000
0001000000000000000000000000000000000000000000000001000000000000001000000000000000001000000000002001000000000000001000000000000001000002000000001000000002000001000002000000002001000002000001000000002000000000000000001000000002000000000000001000000000000001000002000000001000000002000001000002000000002001000002000001000000002000000000000000001000000002000000000000000000000000001000000002000000000000
0001002000002002000000002000000000002000000000000001000002000000001000002000002000001002000000001001000000002000001002000000002001000000000002001002000000002001000000002000000001000000000001002000000000000002000000001000002000002000000002001002000000002001000000000002001002000000002001000000002000000001000000000001002000000000000002000000001000002000002000000002000002000000001000002000002000000002
0001001002001001002002001002002002001002002002002001002000002002001002001002001002001001002002001001002002001002001001002002001001002000002001001001002000001001002000001002000001002000002001001002000002002001002002001002001000001002002001001001002002001001002000002001001001002000001001002000001002000001002000002001001002000002002001002002001002001000001002002001002001002002001002001000001002002001
0001001001001001001001001001001001001001001001001001001001001001001001001001001001001001001001001001001001001001001001001001001001001001001001001001001002001001001002001001002001001002001001001001002001001001001001001001001002001001001001001001001001001001001001001001001001001002001001001002001001002001001002001001001001002001001001001001001001001002001001001001001001001001001001001002001001001001
0001001001001001001001001001001001001001001001001001001001001001001001001001001001001001001001001001001001001001001001001001001001001001001001001001001001001001001001001001001001001001001001001001001001001001001001001001001001001001001001001001001001001001001001001001001001001001001001001001001001001001001001001001001001001001001001001001001001001001001001001001001001001001001001001001001001001001